6 6 6 6 6 6 6 6 6 6 6 6 6 6 6 6 6 6 6 6 6 6 6 6 6 6 6 6 6 6 6 6 6
4 2 4 2 6 2 2 2 6 2 2 6 2 2 6 2 2 2 6 4 2 7 2 2 2 7 4 4 7 2 2 2 6
6 2 4 2 6 2 2 2 6 2 2 6 2 2 6 4 4 2 6 4 2 7 2 7 2 7 4 4 7 2 7 2 6
6 2 4 2 6 2 2 2 6 2 2 6 2 2 6 2 2 2 6 4 2 7 2 7 2 7 7 4 7 2 7 2 6
6 2 4 2 6 2 2 2 4 2 2 6 2 2 6 2 4 4 6 6 2 7 2 7 2 7 2 2 7 2 7 2 6
6 2 4 2 6 2 2 2 6 2 2 6 2 2 6 2 2 2 2 4 2 7 2 7 2 7 2 7 7 2 7 2 6
6 2 4 2 6 2 2 2 6 2 2 6 2 2 6 4 4 2 2 4 2 7 2 7 2 2 2 7 2 2 7 2 6
6 2 4 2 6 2 2 2 6 2 2 6 2 2 6 2 2 2 2 4 2 7 2 7 4 7 4 7 4 4 7 2 6
6 2 4 2 6 2 2 2 6 2 2 4 2 2 6 2 4 4 2 4 2 7 2 7 4 7 7 7 4 4 7 2 6
6 2 4 2 6 2 2 2 6 2 2 6 2 2 6 2 2 2 2 4 2 7 2 7 4 7 4 4 4 2 7 2 6
6 2 4 2 6 2 2 2 6 2 2 6 2 2 6 4 4 2 2 4 2 7 2 2 2 2 2 2 2 2 7 2 6
6 2 4 2 6 2 2 2 6 2 2 2 2 2 4 2 2 2 2 4 2 7 4 4 7 7 7 7 7 4 7 2 6
6 2 4 2 4 2 2 2 6 2 2 6 2 2 6 2 4 4 2 4 2 7 4 4 4 7 4 7 4 4 7 4 6
6 2 4 2 6 2 2 2 6 2 2 6 2 2 6 2 2 2 2 4 2 6 7 7 4 4 4 7 4 7 7 4 6
6 2 4 2 6 2 2 2 6 2 2 6 2 2 6 4 4 2 2 4 2 6 4 7 7 7 7 7 7 7 4 4 6
6 2 4 2 6 2 2 2 6 2 2 6 2 2 6 2 2 2 2 4 2 7 4 4 4 4 4 4 4 4 4 7 6
6 6 6 6 6 6 6 6 6 6 6 6 6 6 6 6 6 6 6 6 6 6 6 6 6 6 6 6 6 6 6 6 6